ADRIFT|ADRIFT
ALONGWITHGODSLAST49DAYS|ALONG WITH THE GODS: THE LAST 49 DAYS
ANDYIRONSKISSEDBYGOD|ANDY IRONS: KISSED BY GOD
ANTMANANDWASP|ANT-MAN AND THE WASP
ASHKE|ASHKE
BANGDREAM5THLIVECONCERTPOPPINPARTY|BANG DREAM! 5TH LIVE CONCERT POPPIN' PARTY
BANGDREAM5THLIVECONCERTROSELIAEWIGKEIT|BANG DREAM! 5TH LIVE CONCERT ROSELIA -EWIGKEIT-
BLACKKKLANSMAN|BLACKKKLANSMAN
BOOKCLUB|BOOK CLUB
BREAKERUPPERERS|THE BREAKER UPPERERS
DAAKUANDAMUNDA|DAAKUAN DA MUNDA
DARKESTMINDS|THE DARKEST MINDS
EDIE|EDIE
ELVIS68COMEBACKSPECIAL|ELVIS: '68 COMEBACK SPECIAL
EQUALIZER2|THE EQUALIZER 2
EUROPERAIDERS|EUROPE RAIDERS
GEETHAGOVINDAM|GEETHA GOVINDAM
GOLD|GOLD
GOODACHARI|GOODACHARI
GREASESINGALONG|GREASE - SING-A-LONG
GREASESINGALONG40THANNIVERSARY|GREASE (SING-ALONG) - 40TH ANNIVERSARY
HEREDITARY|HEREDITARY
HOTELTRANSYLVANIA3|HOTEL TRANSYLVANIA 3
HOTELTRANSYLVANIA3MONSTERVACATION|HOTEL TRANSYLVANIA 3: MONSTER VACATION
IFFAHAREMON|IFF AHARE MON
IFFASHKE|IFF ASHKE
IFFASHRAM|IFF THE ASHRAM
IFFBALEKEMPA|IFF BALEKEMPA
IFFCYCLE|IFF CYCLE
IFFEXTRAORDINARYLIFEOFFAKIR|IFF THE EXTRAORDINARY LIFE OF FAKIR
IFFHAAMI|IFF HAAMI
IFFHAREKRISHNA|IFF HARE KRISHNA
IFFHEBBETREMMEKA|IFF HEBBET REMMEKA
IFFISHUCAKESTORY|IFF ISHU + THE CAKE STORY
IFFJONAKI|IFF JONAKI
IFFRANCHIDIARIES|IFF RANCHI DIARIES
IFFSUMMEROFMIRACLES|IFF THE SUMMER OF MIRACLES
IFFTOLET|IFF TO LET
IFFUMA|IFF UMA
IFFWHITE|IFF WHITE
INCREDIBLES2|INCREDIBLES 2
ISLAND|THE ISLAND 
JEALOUS|JEALOUS
JURASSICWORLDFALLENKINGDOM|JURASSIC WORLD: FALLEN KINGDOM
KARWAAN|KARWAAN
KOLAMAAVUKOKILA|KOLAMAAVU KOKILA
MAMMAMIAHEREWEGOAGAIN|MAMMA MIA! HERE WE GO AGAIN
MAYABEEHONEYGAMES|MAYA THE BEE: THE HONEY GAMES
MCU10CAPTAINAMERICAFIRSTAVENGER|MCU10 CAPTAIN AMERICA: THE FIRST AVENGER
MCU10IRONMAN|MCU10 IRON MAN
MCU10IRONMAN2|MCU10 IRON MAN 2
MCU10THOR|MCU10 THOR
MEG|THE MEG
MEGMANDARIN|THE MEG (MANDARIN)
MISSIONIMPOSSIBLEFALLOUT|MISSION IMPOSSIBLE: FALLOUT
MRMRS420RETURNS|MR. & MRS. 420 RETURNS
OCEANS8|OCEAN'S 8
ONCHESILBEACH|ON CHESIL BEACH
OOLONGCOURTYARDKUNGFUSCHOOL|OOLONG COURTYARD: KUNG FU SCHOOL
SALVADORDALIQUESTFORIMMORTALITY|SALVADOR DALI: THE QUEST FOR IMMORTALITY
SATYAMEVAJAYATE|SATYAMEVA JAYATE
SATYAMEVJAYATE|SATYAMEV JAYATE
SHOWDOGS|SHOW DOGS
SKYSCRAPER|SKYSCRAPER
SPYWHODUMPEDME|THE SPY WHO DUMPED ME
SRINIVASAKALYANAM|SRINIVASA KALYANAM
SUPERFLY|SUPERFLY
THOMASANDFRIENDSBIGWORLDBIGADVENTURE|THOMAS AND FRIENDS: BIG WORLD, BIG ADVENTURE
THOMASFRIENDSBIGWORLDBIGADVENTURES|THOMAS & FRIENDS: BIG WORLD! BIG ADVENTURES
VISHWAROOPAM2|VISHWAROOPAM 2
WIFE|THE WIFE